SalePrice,OverallQual,YearBuilt,TotalBsmtSF,GrLivArea,TotalArea,AreaPerRoom,GarageCars
208500,7,2003,856,1710,2566,213.75,2
181500,6,1976,1262,1262,2524,210.33333333333334,2
223500,7,2001,920,1786,2706,297.6666666666667,2
140000,7,1915,756,1717,2473,245.28571428571428,3
250000,8,2000,1145,2198,3343,244.22222222222223,3
143000,5,1993,796,1362,2158,272.4,2
307000,8,2004,1686,1694,3380,242.0,2
200000,7,1973,1107,2090,3197,298.57142857142856,2
129900,7,1931,952,1774,2726,221.75,2
118000,5,1939,991,1077,2068,215.4,1
129500,5,1965,1040,1040,2080,208.0,1
345000,9,2005,1175,2324,3499,211.27272727272728,3
144000,5,1962,912,912,1824,228.0,1
279500,7,2006,1494,1494,2988,213.42857142857142,3
157000,6,1960,1253,1253,2506,250.6,1
132000,7,1929,832,854,1686,170.8,2
149000,6,1970,1004,1004,2008,200.8,2
90000,4,1967,0,1296,1296,216.0,2
159000,5,2004,1114,1114,2228,185.66666666666666,2
139000,5,1958,1029,1339,2368,223.16666666666666,1
325300,8,2005,1158,2376,3534,264.0,3
139400,7,1930,637,1108,1745,184.66666666666666,1
230000,8,2002,1777,1795,3572,256.42857142857144,2
129900,5,1976,1040,1060,2100,176.66666666666666,2
154000,5,1968,1060,1060,2120,176.66666666666666,1
256300,8,2007,1566,1600,3166,228.57142857142858,3
134800,5,1951,900,900,1800,180.0,2
306000,8,2007,1704,1704,3408,243.42857142857142,3
207500,5,1957,1484,1600,3084,266.6666666666667,1
68500,4,1927,520,520,1040,130.0,1
40000,4,1920,649,1317,1966,219.5,1
149350,5,1966,1228,1228,2456,204.66666666666666,1
179900,8,2007,1234,1234,2468,176.28571428571428,2
165500,5,1959,1398,1700,3098,283.3333333333333,2
277500,9,2005,1561,1561,3122,260.1666666666667,2
309000,8,2004,1117,2452,3569,272.44444444444446,3
145000,5,1994,1097,1097,2194,182.83333333333334,2
153000,5,1954,1297,1297,2594,259.4,2
109000,5,1953,1057,1057,2114,211.4,1
82000,4,1955,0,1152,1152,192.0,0
160000,6,1965,1088,1324,2412,220.66666666666666,2
170000,5,1959,1350,1328,2678,265.6,1
144000,5,1983,840,884,1724,176.8,2
130250,5,1975,938,938,1876,187.6,1
141000,5,1959,1150,1150,2300,191.66666666666666,1
319900,9,2005,1752,1752,3504,292.0,2
239686,7,2003,1434,2149,3583,358.1666666666667,2
249700,8,2006,1656,1656,3312,236.57142857142858,3
113000,4,1920,736,1452,2188,181.5,0
127000,5,1966,955,955,1910,159.16666666666666,1
177000,6,1997,794,1470,2264,245.0,2
114500,6,1934,816,1176,1992,196.0,2
110000,5,1963,816,816,1632,163.2,2
385000,9,1981,1842,1842,3684,368.4,3
130000,5,1955,384,1360,1744,226.66666666666666,2
180500,6,1964,1425,1425,2850,203.57142857142858,2
172500,8,1999,970,1739,2709,248.42857142857142,2
196500,7,2004,860,1720,2580,245.71428571428572,2
438780,10,2006,1410,2945,4355,294.5,3
124900,5,1972,780,780,1560,195.0,1
158000,6,2004,1158,1158,2316,231.6,2
101000,5,1920,530,1111,1641,185.16666666666666,1
202500,8,2006,1370,1370,2740,228.33333333333334,2
140000,7,1921,576,1710,2286,190.0,2
219500,7,1997,1057,2034,3091,254.25,2
317000,8,2004,1143,2473,3616,274.77777777777777,3
180000,7,1970,1947,2207,4154,315.2857142857143,2
226000,7,2003,1453,1479,2932,211.28571428571428,2
80000,4,1945,747,747,1494,186.75,1
225000,7,1953,1304,2287,3591,326.7142857142857,2
244000,7,1973,2223,2223,4446,277.875,2
129500,4,1982,845,845,1690,211.25,2
185000,7,1998,832,1718,2550,245.42857142857142,2
144900,5,1954,1086,1086,2172,181.0,2
107400,3,1915,840,1605,2445,200.625,1
91000,4,1973,462,988,1450,197.6,1
135750,4,1956,952,952,1904,238.0,1
127000,5,1948,672,1285,1957,214.16666666666666,1
136500,4,1968,1768,1768,3536,221.0,0
110000,5,1910,440,1230,1670,246.0,2
193500,6,1968,896,2142,3038,267.75,1
153500,6,1998,1237,1337,2574,267.4,2
245000,8,2007,1563,1563,3126,260.5,3
126500,5,1960,1065,1065,2130,177.5,2
168500,7,1995,384,1474,1858,210.57142857142858,2
260000,8,1991,1288,2417,3705,268.55555555555554,2
174000,6,2005,684,1560,2244,260.0,2
164500,6,2009,612,1224,1836,306.0,2
85000,3,1915,1013,1526,2539,254.33333333333334,0
123600,4,1994,990,990,1980,198.0,0
109900,4,1950,0,1040,1040,260.0,2
98600,5,1961,1235,1235,2470,205.83333333333334,2
163500,5,1921,876,964,1840,192.8,2
133900,6,1910,1214,2291,3505,254.55555555555554,2
204750,6,1997,824,1786,2610,255.14285714285714,2
185000,6,1993,680,1470,2150,245.0,2
214000,7,1999,1588,1588,3176,264.6666666666667,2
94750,4,1965,960,960,1920,160.0,1
83000,5,1920,458,835,1293,167.0,1
128950,4,1959,950,1225,2175,204.16666666666666,0
205000,6,1977,1610,1610,3220,268.3333333333333,2
178000,6,1985,741,1732,2473,247.42857142857142,2
118964,5,1979,0,1535,1535,191.875,2
198900,7,2009,1226,1226,2452,204.33333333333334,3
169500,7,1931,1040,1818,2858,259.7142857142857,1
250000,8,2003,1053,1992,3045,221.33333333333334,2
100000,4,1885,641,1047,1688,174.5,1
115000,5,1948,789,789,1578,157.8,1
115000,5,1919,793,1517,2310,216.71428571428572,0
190000,6,1977,1844,1844,3688,263.42857142857144,2
136900,6,1954,994,1855,2849,265.0,1
180000,7,2000,384,1430,1814,204.28571428571428,2
383970,7,2007,1264,2696,3960,269.6,3
217000,6,1953,1809,2259,4068,322.7142857142857,2
259500,6,1945,1028,2320,3348,257.77777777777777,1
176000,6,1999,729,1458,2187,291.6,2
139000,5,1962,1092,1092,2184,182.0,1
155000,5,2006,1125,1125,2250,225.0,2
320000,7,1990,1673,3222,4895,292.90909090909093,3
163990,6,2005,728,1456,2184,182.0,2
180000,6,1969,938,988,1926,247.0,2
100000,4,1939,732,1123,1855,280.75,1
136000,6,1958,1080,1080,2160,216.0,1
153900,6,1993,1199,1199,2398,239.8,2
181000,6,1979,1362,1586,2948,226.57142857142858,2
84500,6,1935,520,754,1274,150.8,0
128000,6,1976,1078,958,2036,191.6,2
87000,5,1930,672,840,1512,168.0,0
155000,6,1966,660,1348,2008,224.66666666666666,2
150000,5,1958,1008,1053,2061,175.5,2
226000,7,1966,924,2157,3081,269.625,2
244000,6,2000,992,2054,3046,293.42857142857144,2
150750,5,1959,1063,1327,2390,189.57142857142858,2
220000,8,2001,1267,1296,2563,216.0,2
180000,5,1968,1461,1721,3182,245.85714285714286,2
174000,7,1970,1304,1682,2986,240.28571428571428,2
143000,5,1967,1214,1214,2428,242.8,1
171000,7,1988,1907,1959,3866,217.66666666666666,3
230000,8,1999,1004,1852,2856,264.57142857142856,3
231500,6,1997,928,1764,2692,252.0,2
115000,4,1971,864,864,1728,172.8,0
260000,7,2005,1734,1734,3468,247.71428571428572,2
166000,5,1952,910,1385,2295,230.83333333333334,2
204000,7,1999,1490,1501,2991,250.16666666666666,2
125000,5,1963,1728,1728,3456,172.8,2
130000,6,2004,970,1709,2679,244.14285714285714,2
105000,5,1931,715,875,1590,175.0,1
222500,7,2001,884,2035,2919,254.375,2
141000,7,2004,1080,1080,2160,180.0,0
115000,5,1936,896,1344,2240,192.0,1
122000,5,1975,969,969,1938,193.8,2
372402,8,2007,1710,1710,3420,285.0,3
190000,6,1971,825,1993,2818,249.125,2
235000,6,1960,1602,1252,2854,313.0,2
125000,6,1923,1200,1200,2400,171.42857142857142,1
79000,6,1924,572,1096,1668,219.2,0
109500,5,1950,0,1040,1040,208.0,2
269500,8,2009,774,1968,2742,246.0,3
254900,7,2004,991,1947,2938,243.375,2
320000,7,2005,1392,2462,3854,273.55555555555554,2
162500,6,1984,1232,1232,2464,205.33333333333334,2
412500,9,2003,1572,2668,4240,266.8,3
220000,7,2005,1541,1541,3082,220.14285714285714,2
103200,4,1956,882,882,1764,220.5,0
152000,6,1926,1149,1616,2765,323.2,1
127500,5,1940,644,1355,1999,225.83333333333334,0
190000,5,1955,1617,1867,3484,266.7142857142857,1
325624,8,2007,1582,2161,3743,270.125,3
183500,7,2004,840,1720,2560,245.71428571428572,2
228000,8,1981,1686,1707,3393,284.5,2
128500,5,1941,720,1382,2102,197.42857142857142,2
215000,6,1960,1080,1656,2736,236.57142857142858,2
239000,7,1987,1064,1767,2831,353.4,2
163000,6,1961,1362,1362,2724,227.0,2
184000,6,1986,1606,1651,3257,235.85714285714286,2
243000,6,1950,1202,2158,3360,308.2857142857143,2
211000,6,1988,1151,2060,3211,257.5,2
172500,5,1958,1052,1920,2972,240.0,2
501837,9,2008,2216,2234,4450,248.22222222222223,3
100000,5,1923,968,968,1936,193.6,2
177000,6,2000,756,1525,2281,305.0,2
200100,7,1920,793,1802,2595,200.22222222222223,1
120000,5,1957,0,1340,1340,191.42857142857142,1
200000,7,2003,1362,2082,3444,347.0,2
127000,5,1908,504,1252,1756,250.4,2
475000,10,1892,1107,3608,4715,300.6666666666667,3
173000,7,1990,1188,1217,2405,202.83333333333334,2
135000,5,1916,660,1656,2316,207.0,1
153337,5,1979,1086,1224,2310,204.0,2
286000,8,2001,1593,1593,3186,318.6,2
315000,8,1932,853,2727,3580,272.7,2
184000,7,1972,725,1479,2204,211.28571428571428,2
192000,7,1999,1431,1431,2862,238.5,2
130000,7,2004,970,1709,2679,244.14285714285714,2
127000,5,1972,864,864,1728,172.8,1
148500,6,1976,855,1456,2311,208.0,2
311872,7,2007,1726,1726,3452,215.75,3
235000,8,1918,1360,3112,4472,389.0,2
104000,6,1912,755,2229,2984,278.625,0
274900,8,2004,1713,1713,3426,244.71428571428572,3
140000,4,2003,1121,1121,2242,224.2,2
171500,6,1977,1196,1279,2475,213.16666666666666,2
112000,6,1924,617,1310,1927,218.33333333333334,1
149000,6,2004,848,848,1696,282.6666666666667,2
110000,5,1947,720,1284,2004,256.8,1
180500,7,1990,1424,1442,2866,288.4,2
143900,5,1962,1140,1696,2836,212.0,1
141000,4,1960,1100,1100,2200,183.33333333333334,1
277000,7,1988,1157,2062,3219,294.57142857142856,2
145000,6,1964,1092,1092,2184,182.0,2
98000,5,1925,864,864,1728,172.8,0
186000,6,2009,1212,1212,2424,202.0,2
252678,7,2009,900,1852,2752,264.57142857142856,2
156000,5,1995,990,990,1980,198.0,2
161750,6,1977,689,1392,2081,232.0,1
134450,5,1957,1070,1236,2306,206.0,1
210000,7,2004,1436,1436,2872,179.5,2
107000,4,1925,686,1328,2014,166.0,1
311500,7,1939,798,1954,2752,244.25,2
167240,7,2005,1248,1248,2496,249.6,2
204900,7,2006,1498,1498,2996,299.6,2
200000,6,2002,1010,2267,3277,283.375,2
179900,6,1975,713,1552,2265,258.6666666666667,2
97000,4,1971,864,864,1728,216.0,2
386250,10,2003,2392,2392,4784,299.0,3
112000,5,1971,630,1302,1932,217.0,1
290000,7,1995,1203,2520,3723,280.0,3
106000,6,1970,483,987,1470,197.4,1
125000,5,1967,912,912,1824,182.4,1
192500,7,2005,1373,1555,2928,222.14285714285714,2
148000,6,1959,1194,1194,2388,199.0,1
403000,8,1995,1462,2794,4256,310.44444444444446,3
94500,6,1972,483,987,1470,197.4,1
128200,5,1976,894,894,1788,178.8,1
216500,6,2002,860,1960,2820,245.0,2
89500,6,1971,483,987,1470,197.4,1
185500,7,2004,1414,1414,2828,235.66666666666666,2
194500,7,1993,996,1744,2740,249.14285714285714,2
318000,8,2007,1694,1694,3388,242.0,3
113000,6,1945,735,1487,2222,212.42857142857142,1
262500,8,2008,1566,1566,3132,223.71428571428572,2
110500,5,1945,686,866,1552,216.5,0
79000,5,1900,540,1440,1980,240.0,1
120000,6,1980,626,1217,1843,202.83333333333334,1
205000,7,1994,948,2110,3058,263.75,2
241500,7,1988,1845,1872,3717,312.0,2
137000,6,1910,1020,1928,2948,214.22222222222223,1
140000,6,1954,1367,1375,2742,275.0,2
180000,7,2003,840,1668,2508,208.5,2
277000,6,1958,1444,2144,3588,306.2857142857143,2
76500,3,1940,728,1306,2034,217.66666666666666,0
235000,8,2006,1573,1625,3198,325.0,2
173000,6,2004,798,1640,2438,273.3333333333333,2
158000,6,1964,1302,1302,2604,186.0,1
145000,5,1957,1314,1314,2628,262.8,1
230000,7,1999,975,2291,3266,286.375,2
207500,6,2003,864,1728,2592,246.85714285714286,2
220000,7,2006,1604,1604,3208,200.5,2
231500,7,2001,963,1792,2755,256.0,2
97000,5,1956,0,882,882,220.5,1
176000,6,1962,1362,1382,2744,230.33333333333334,2
276000,8,2007,1482,2574,4056,257.4,3
151000,6,1977,506,1212,1718,202.0,2
130000,5,1929,926,1316,2242,219.33333333333334,2
73000,5,1925,680,764,1444,191.0,2
175500,6,1981,1422,1422,2844,203.14285714285714,2
185000,6,1997,802,1511,2313,188.875,2
179500,5,1939,720,2192,2912,274.0,1
120500,5,1940,740,778,1518,194.5,1
148000,6,1976,1143,1113,2256,185.5,1
266000,8,2006,1095,1939,3034,242.375,3
241500,7,1954,1385,1363,2748,272.6,2
290000,8,1999,1152,2270,3422,252.22222222222223,3
139000,6,1958,1240,1632,2872,272.0,1
124500,5,1982,816,816,1632,163.2,1
205000,7,1925,952,1548,2500,309.6,2
201000,7,2003,1560,1560,3120,222.85714285714286,2
141000,4,1951,864,864,1728,216.0,2
415298,9,2006,2121,2121,4242,265.125,3
192000,7,1977,1160,2022,3182,252.75,2
228500,7,1989,807,1982,2789,283.14285714285717,2
185000,6,2006,1262,1262,2524,252.4,2
207500,7,2007,1314,1314,2628,219.0,2
244600,8,2008,1468,1468,2936,244.66666666666666,3
179200,6,1992,1575,1575,3150,315.0,2
164700,7,2006,625,1250,1875,250.0,2
159000,6,1962,912,1734,2646,247.71428571428572,2
88000,4,1971,858,858,1716,171.6,0
122000,5,1967,882,900,1782,180.0,1
153575,6,1915,698,1396,2094,199.42857142857142,1
233230,8,2006,1079,1919,2998,239.875,2
135900,5,1912,780,1716,2496,190.66666666666666,0
131000,5,1949,768,1716,2484,214.5,1
235000,7,1977,795,2263,3058,251.44444444444446,2
167000,6,1953,1416,1644,3060,234.85714285714286,2
142500,6,1984,1003,1003,2006,167.16666666666666,2
152000,5,1950,910,1558,2468,259.6666666666667,1
239000,7,1997,975,1950,2925,278.57142857142856,2
175000,6,1968,702,1743,2445,249.0,2
158500,6,1950,1092,1152,2244,192.0,1
157000,5,1953,1165,1336,2501,267.2,1
267000,8,1998,1028,2452,3480,272.44444444444446,2
205000,7,2001,1541,1541,3082,256.8333333333333,3
149900,5,1972,894,894,1788,178.8,2
295000,7,1880,1470,3493,4963,349.3,3
305900,8,2004,2000,2000,4000,250.0,3
225000,7,1990,700,2243,2943,280.375,3
89500,6,1920,319,1406,1725,234.33333333333334,0
82500,4,1940,861,861,1722,215.25,2
360000,9,2003,1896,1944,3840,243.0,3
165600,6,1993,697,1501,2198,250.16666666666666,2
132000,6,1948,972,972,1944,194.4,1
119900,5,1939,793,1118,1911,223.6,2
375000,7,1965,2136,2036,4172,254.5,2
178000,7,1925,728,1641,2369,273.5,2
188500,7,2004,716,1432,2148,238.66666666666666,2
260000,7,1980,845,2353,3198,235.3,2
270000,8,2006,1088,1959,3047,244.875,3
260000,7,1993,1347,2646,3993,294.0,3
187500,7,1980,1372,1472,2844,245.33333333333334,2
342643,9,2006,1249,2596,3845,288.44444444444446,3
354000,8,2004,1136,2468,3604,246.8,3
301000,7,1986,1502,2730,4232,341.25,2
126175,3,1955,1162,1163,2325,193.83333333333334,1
242000,7,1967,710,2978,3688,270.72727272727275,2
87000,5,1941,720,803,1523,160.6,2
324000,8,1993,1719,1719,3438,286.5,2
145250,6,1960,1383,1383,2766,197.57142857142858,1
214500,6,1916,844,2134,2978,213.4,2
78000,5,1920,596,1192,1788,198.66666666666666,1
119000,5,1964,1728,1728,3456,172.8,1
139000,5,1958,1056,1056,2112,176.0,1
284000,8,2003,3206,1629,4835,232.71428571428572,3
207000,7,2004,1358,1358,2716,226.33333333333334,2
192000,6,1998,943,1638,2581,234.0,2
228950,5,1965,1499,1786,3285,255.14285714285714,2
377426,9,2005,1922,1922,3844,240.25,3
214000,7,2002,1536,1536,3072,219.42857142857142,2
202500,7,1984,1208,1621,2829,202.625,2
155000,6,1958,1215,1215,2430,202.5,1
202900,8,2002,967,1908,2875,212.0,2
82000,4,1950,721,841,1562,210.25,1
87500,3,1949,0,1040,1040,173.33333333333334,2
266000,9,2005,1684,1684,3368,280.6666666666667,2
85000,5,1976,536,1112,1648,278.0,1
140200,6,1939,972,1577,2549,262.8333333333333,1
151500,6,1960,958,958,1916,191.6,1
157500,6,1960,1478,1478,2956,246.33333333333334,2
154000,7,2003,764,1626,2390,271.0,2
437154,9,2005,1848,2728,4576,272.8,3
318061,9,2007,1869,1869,3738,311.5,2
190000,7,1986,1453,1453,2906,242.16666666666666,2
95000,5,1941,616,1111,1727,222.2,1
105900,6,1928,624,720,1344,144.0,2
140000,6,1940,940,1595,2535,265.8333333333333,1
177500,6,1995,1200,1200,2400,200.0,2
173000,6,1992,1158,1167,2325,194.5,2
134000,5,1976,1142,1142,2284,190.33333333333334,2
130000,5,1958,1062,1352,2414,225.33333333333334,1
280000,8,1998,1086,1924,3010,274.85714285714283,2
156000,6,1978,888,912,1800,182.4,2
145000,5,1940,883,1505,2388,188.125,1
198500,7,2003,0,1922,1922,274.57142857142856,2
118000,6,1972,483,987,1470,197.4,1
190000,6,1976,796,1574,2370,262.3333333333333,2
147000,5,1920,672,1344,2016,224.0,1
159000,6,1963,1394,1394,2788,232.33333333333334,2
165000,6,1962,1099,1431,2530,238.5,1
132000,5,1954,1268,1268,2536,181.14285714285714,1
162000,5,1959,1063,1287,2350,183.85714285714286,2
172400,6,2000,953,1664,2617,237.71428571428572,2
134432,4,1959,0,1588,1588,226.85714285714286,2
125000,6,1984,744,752,1496,188.0,1
123000,5,1953,608,1319,1927,263.8,1
219500,7,2003,847,1928,2775,241.0,2
61000,1,1922,683,904,1587,226.0,0
148000,5,1996,870,914,1784,182.8,2
340000,8,2004,1580,2466,4046,308.25,2
394432,9,2010,1856,1856,3712,232.0,3
179000,6,2000,982,1800,2782,257.14285714285717,2
127000,5,1924,1026,1691,2717,281.8333333333333,1
187750,7,2006,1293,1301,2594,260.2,2
213500,7,2006,939,1797,2736,224.625,2
76000,6,1928,784,784,1568,156.8,2
240000,6,1992,1580,1953,3533,217.0,2
192000,8,2004,1256,1269,2525,211.5,2
81000,5,1910,658,1184,1842,148.0,0
125000,6,1976,1041,1125,2166,187.5,1
191000,7,1999,1468,1479,2947,246.5,2
426000,10,2007,1682,2332,4014,259.1111111111111,3
119000,5,1900,861,1367,2228,195.28571428571428,1
215000,6,2001,804,1961,2765,280.14285714285717,2
106500,5,1959,0,882,882,176.4,1
100000,4,1941,788,788,1576,197.0,0
109000,5,1940,735,1034,1769,206.8,1
129000,5,1956,1144,1144,2288,190.66666666666666,1
123000,5,1972,894,894,1788,149.0,2
169500,5,1962,864,1812,2676,226.5,1
67000,5,1920,961,1077,2038,179.5,1
241000,7,2006,1092,1550,2642,221.42857142857142,2
245500,8,1996,1260,1288,2548,322.0,2
164990,7,2005,1310,1310,2620,218.33333333333334,2
108000,5,1940,672,672,1344,168.0,1
258000,8,1998,1141,2263,3404,226.3,2
168000,6,1995,806,1572,2378,224.57142857142858,2
150000,4,1976,1281,1620,2901,202.5,2
115000,6,1936,1064,1639,2703,273.1666666666667,1
177000,6,1915,840,1680,2520,210.0,1
280000,7,2006,1063,2172,3235,241.33333333333334,3
339750,8,2007,1034,2078,3112,259.75,3
60000,5,1958,1276,1276,2552,255.2,1
145000,5,1955,1056,1056,2112,211.2,2
222000,7,2009,1470,1478,2948,211.14285714285714,2
115000,5,1927,1008,1028,2036,205.6,2
228000,7,1993,1080,2097,3177,233.0,3
181134,7,2007,1340,1340,2680,223.33333333333334,2
149500,6,1978,672,1400,2072,233.33333333333334,2
239000,6,1918,1370,2624,3994,262.4,3
126000,5,1940,756,1134,1890,162.0,1
142000,5,1968,1056,1056,2112,176.0,1
206300,7,1997,1344,1344,2688,168.0,4
215000,6,1977,1602,1602,3204,200.25,2
113000,5,1954,988,988,1976,247.0,2
315000,8,1998,1470,2630,4100,328.75,3
139000,6,1956,1196,1196,2392,199.33333333333334,1
135000,7,1946,651,1389,2040,231.5,1
275000,7,1989,1518,1644,3162,328.8,2
109008,4,1957,907,907,1814,181.4,1
195400,7,2007,1208,1208,2416,201.33333333333334,2
175000,6,1988,1392,1412,2804,235.33333333333334,2
85400,6,1971,483,987,1470,246.75,1
79900,6,1920,901,1198,2099,171.14285714285714,0
122500,5,1971,765,1365,2130,227.5,2
181000,6,1997,926,1604,2530,229.14285714285714,2
81000,4,1972,630,630,1260,210.0,0
212000,7,1996,799,1661,2460,276.8333333333333,2
116000,6,1920,648,1118,1766,186.33333333333334,2
119000,6,1926,884,904,1788,226.0,1
90350,5,1913,440,694,1134,173.5,1
110000,6,1920,684,1196,1880,170.85714285714286,2
555000,10,2008,3094,2402,5496,240.2,3
118000,4,1955,1440,1440,2880,180.0,0
162900,5,1930,1078,1573,2651,196.625,2
172500,7,2006,1258,1258,2516,209.66666666666666,3
210000,7,1994,915,1908,2823,238.5,2
127500,6,1956,1436,1689,3125,241.28571428571428,2
190000,6,1966,1517,1888,3405,314.6666666666667,2
199900,7,1998,930,1886,2816,188.6,2
119500,6,1937,780,1376,2156,196.57142857142858,1
120000,3,1948,649,1183,1832,197.16666666666666,1
110000,6,1930,813,813,1626,162.6,1
280000,7,1975,1533,1533,3066,306.6,2
204000,6,1996,872,1756,2628,250.85714285714286,2
210000,8,2008,768,1590,2358,265.0,2
188000,5,1976,1728,1728,3456,216.0,2
175500,7,1973,1242,1242,2484,207.0,2
98000,5,1916,624,1344,1968,192.0,3
256000,4,1954,1364,1663,3027,277.1666666666667,2
161000,8,1925,588,1666,2254,238.0,1
110000,5,1950,709,1203,1912,240.6,1
263435,8,2009,832,1935,2767,241.875,2
155000,7,1936,560,1135,1695,189.16666666666666,2
62383,5,1965,864,864,1728,172.8,1
188700,6,1934,715,1660,2375,276.6666666666667,1
124000,5,1978,1040,1040,2080,208.0,0
178740,7,2004,1375,1414,2789,235.66666666666666,2
167000,7,1970,1277,1277,2554,255.4,2
146500,5,1942,728,1644,2372,234.85714285714286,1
250000,8,2006,1626,1634,3260,233.42857142857142,3
187000,6,1993,832,1710,2542,244.28571428571428,2
212000,8,1985,1488,1502,2990,375.5,2
190000,7,1977,808,1969,2777,246.125,2
148000,6,2005,547,1072,1619,214.4,2
440000,8,2006,1976,1976,3952,282.2857142857143,3
251000,8,2000,1494,1652,3146,275.3333333333333,2
132500,5,1963,970,970,1940,194.0,2
208900,6,1997,1478,1493,2971,213.28571428571428,2
380000,9,2006,2153,2643,4796,293.6666666666667,3
297000,8,2007,1705,1718,3423,245.42857142857142,3
89471,4,1937,907,1131,2038,161.57142857142858,2
326000,9,2004,1833,1850,3683,231.25,3
374000,9,2003,1792,1792,3584,298.6666666666667,3
155000,7,1915,910,1826,2736,260.85714285714283,1
164000,6,1998,1216,1216,2432,243.2,2
132500,5,1962,999,999,1998,166.5,1
147000,5,1950,1113,1113,2226,222.6,1
156000,5,1965,1073,1073,2146,178.83333333333334,2
175000,5,1971,1484,1484,2968,212.0,2
160000,5,1900,954,2414,3368,241.4,2
86000,4,1970,630,630,1260,210.0,1
115000,5,1976,264,1304,1568,326.0,1
133000,6,1941,806,1578,2384,315.6,1
172785,6,2006,728,1456,2184,182.0,2
155000,5,1960,1269,1269,2538,211.5,1
91300,5,1938,190,886,1076,221.5,1
34900,4,1920,720,720,1440,180.0,0
430000,8,1992,3200,3228,6428,322.8,2
184000,7,1925,1026,1820,2846,227.5,1
130000,5,1967,864,899,1763,179.8,1
120000,5,1958,912,912,1824,182.4,1
113000,6,1973,672,1218,1890,174.0,1
226700,7,2005,866,1768,2634,252.57142857142858,2
140000,5,1965,1214,1214,2428,202.33333333333334,2
289000,7,1959,1501,1801,3302,300.1666666666667,2
147000,6,1974,855,1322,2177,220.33333333333334,2
124500,5,1952,960,1960,2920,196.0,2
215000,8,1993,777,1911,2688,238.875,2
208300,6,2009,1218,1218,2436,304.5,2
161000,7,1928,689,1378,2067,196.85714285714286,2
124500,5,1959,1041,1041,2082,173.5,1
164900,5,1951,1008,1363,2371,227.16666666666666,1
202665,7,2005,1368,1368,2736,228.0,2
129900,5,1958,864,864,1728,172.8,2
134000,6,1983,1084,1080,2164,216.0,2
96500,5,1926,768,789,1557,157.8,1
402861,10,2009,2006,2020,4026,224.44444444444446,3
158000,6,1972,689,2119,2808,302.7142857142857,2
265000,7,1996,1264,2344,3608,334.85714285714283,3
211000,6,1998,794,1796,2590,256.57142857142856,2
234000,7,1926,1276,2080,3356,231.11111111111111,1
106250,4,1900,0,1294,1294,184.85714285714286,0
150000,6,1957,1244,1244,2488,207.33333333333334,1
159000,6,1947,1004,1664,2668,237.71428571428572,2
184750,10,2007,3138,4676,7814,425.09090909090907,3
315750,7,1996,1379,2398,3777,299.75,3
176000,7,2005,1257,1266,2523,211.0,2
132000,5,1956,928,928,1856,232.0,1
446261,9,2008,1452,2713,4165,246.63636363636363,3
86000,4,1920,528,605,1133,121.0,0
200624,6,1957,2035,2515,4550,279.44444444444446,2
175000,6,1988,1461,1509,2970,301.8,2
128000,6,1920,611,1362,1973,227.0,2
107500,5,1955,0,827,827,165.4,1
39300,1,1946,0,334,334,167.0,0
178000,8,2004,707,1414,2121,235.66666666666666,2
107500,5,1910,1117,1347,2464,269.4,0
188000,7,1998,880,1724,2604,215.5,2
111250,4,1972,864,864,1728,172.8,2
158000,5,1968,1051,1159,2210,165.57142857142858,1
272000,8,2001,1581,1601,3182,266.8333333333333,2
315000,9,2006,1838,1838,3676,229.75,3
248000,8,2000,969,2285,3254,285.625,3
213250,7,1998,1650,1680,3330,240.0,2
133000,7,1998,723,767,1490,191.75,1
179665,7,2006,654,1496,2150,213.71428571428572,2
229000,7,1988,1204,2183,3387,242.55555555555554,3
210000,6,1923,1065,1635,2700,272.5,2
129500,5,1970,768,768,1536,153.6,2
125000,5,1955,825,825,1650,206.25,2
263000,7,2003,912,2094,3006,261.75,2
140000,6,1977,1069,1069,2138,267.25,2
112500,5,1957,928,928,1856,185.6,1
255500,8,2006,1709,1717,3426,245.28571428571428,3
108000,4,1949,0,1126,1126,225.2,2
284000,7,2003,998,2046,3044,255.75,3
113000,5,1922,993,1048,2041,209.6,1
141000,5,1957,1092,1092,2184,182.0,1
108000,4,1920,637,1336,1973,190.85714285714286,1
175000,7,1996,729,1446,2175,241.0,2
234000,7,2003,1374,1557,2931,222.42857142857142,2
121500,5,1957,1392,1392,2784,278.4,2
170000,5,1974,1389,1389,2778,231.5,2
108000,5,1940,996,996,1992,166.0,0
185000,6,1918,1163,1674,2837,209.25,2
268000,7,1992,1095,2295,3390,255.0,2
128000,6,1915,806,1647,2453,274.5,1
325000,9,2005,1122,2504,3626,227.63636363636363,3
214000,7,2004,1517,1535,3052,219.28571428571428,2
316600,8,1983,1496,2132,3628,426.4,2
135960,5,1979,943,943,1886,235.75,2
142600,5,1965,1728,1728,3456,172.8,2
120000,6,1959,864,864,1728,216.0,1
224500,7,2009,846,1692,2538,282.0,2
170000,7,2000,384,1430,1814,178.75,2
139000,5,1971,372,1109,1481,221.8,1
118500,5,1947,832,1216,2048,202.66666666666666,1
145000,7,1928,861,1477,2338,246.16666666666666,1
164500,5,1966,1164,1320,2484,220.0,2
146000,7,2007,689,1392,2081,278.4,2
131500,5,1954,1050,1795,2845,256.42857142857144,1
181900,6,1960,1144,1429,2573,204.14285714285714,2
253293,8,2008,2042,2042,4084,255.25,3
118500,6,1990,816,816,1632,163.2,0
325000,10,1893,1237,2775,4012,308.3333333333333,2
133000,4,1935,884,1573,2457,262.1666666666667,1
369900,8,2005,1868,2028,3896,289.7142857142857,3
130000,6,1918,816,838,1654,167.6,1
137000,5,1982,840,860,1700,215.0,2
143000,5,1968,1437,1473,2910,294.6,1
79500,5,1930,742,935,1677,233.75,1
185900,7,2004,770,1582,2352,263.6666666666667,2
451950,10,2008,1722,2296,4018,229.6,3
138000,5,1982,816,816,1632,204.0,2
140000,6,2003,848,848,1696,212.0,2
110000,5,1975,924,924,1848,184.8,1
319000,8,2005,1814,1826,3640,260.85714285714283,3
114504,6,1910,684,1368,2052,195.42857142857142,1
194201,7,2006,1258,1402,2660,200.28571428571428,3
217500,5,1977,1430,1647,3077,235.28571428571428,2
151000,6,1980,716,1556,2272,259.3333333333333,2
275000,8,2005,1058,1904,2962,238.0,2
141000,6,1937,780,1375,2155,229.16666666666666,1
220000,8,1992,908,1915,2823,239.375,2
151000,7,2004,600,1200,1800,300.0,2
221000,7,2002,1494,1494,2988,249.0,2
205000,7,1965,768,1986,2754,283.7142857142857,2
152000,5,1996,1040,1040,2080,173.33333333333334,2
225000,5,1948,896,2008,2904,251.0,1
359100,8,1934,965,3194,4159,319.4,2
118500,4,1961,1029,1029,2058,205.8,1
313000,9,2000,1440,2153,3593,269.125,3
148000,6,1978,1032,1032,2064,172.0,2
261500,8,2001,1299,1872,3171,267.42857142857144,2
147000,5,2007,1120,1120,2240,186.66666666666666,0
75500,4,1972,630,630,1260,210.0,0
137500,6,1963,936,1054,1990,175.66666666666666,2
183200,6,2002,783,1509,2292,215.57142857142858,2
105500,6,1954,832,832,1664,208.0,2
314813,9,2007,1822,1828,3650,203.11111111111111,3
305000,8,2003,1482,2262,3744,226.2,3
67000,3,1914,864,864,1728,172.8,0
240000,6,1974,1522,2614,4136,290.44444444444446,2
135000,5,1977,980,980,1960,163.33333333333334,2
168500,6,2000,756,1512,2268,378.0,2
165150,6,1972,732,1790,2522,223.75,2
160000,6,1962,1116,1116,2232,223.2,2
139900,5,1960,978,1422,2400,237.0,1
153000,6,1955,1156,1520,2676,217.14285714285714,1
135000,5,1969,1040,2080,3120,231.11111111111111,2
168500,6,1964,1248,1350,2598,225.0,2
124000,5,1880,636,1750,2386,218.75,1
209500,8,2006,1554,1554,3108,259.0,2
82500,7,1977,1386,1411,2797,235.16666666666666,2
139400,5,1954,1056,1056,2112,176.0,1
144000,6,1980,1056,1056,2112,264.0,2
200000,6,1914,1440,3395,4835,242.5,0
60000,2,1936,264,800,1064,200.0,0
93000,5,1954,811,1387,2198,198.14285714285714,1
85000,5,1910,796,796,1592,199.0,0
264561,8,2006,1520,1567,3087,223.85714285714286,3
274000,8,2003,1518,1518,3036,253.0,2
226000,7,2001,1057,1929,2986,275.57142857142856,2
345000,8,1972,1952,2704,4656,300.44444444444446,2
152000,5,1969,780,1620,2400,231.42857142857142,2
370878,9,2009,1766,1766,3532,252.28571428571428,3
143250,6,1971,981,981,1962,196.2,2
98300,5,1950,0,1048,1048,149.71428571428572,2
155000,6,1953,1094,1094,2188,218.8,2
155000,6,1966,756,1839,2595,262.7142857142857,2
84500,4,1970,630,630,1260,210.0,0
205950,7,2007,813,1665,2478,237.85714285714286,2
108000,4,1940,755,1510,2265,215.71428571428572,1
191000,7,1996,880,1716,2596,245.14285714285714,2
135000,6,1906,756,1469,2225,209.85714285714286,1
350000,8,1995,2109,2113,4222,301.85714285714283,3
88000,6,1971,525,1092,1617,182.0,1
145500,5,1959,1053,1053,2106,210.6,1
149000,7,1931,776,1502,2278,250.33333333333334,1
97500,6,1948,912,1458,2370,243.0,1
167000,5,1964,1486,1486,2972,212.28571428571428,2
197900,7,1976,793,1935,2728,276.42857142857144,2
402000,8,1994,1629,2448,4077,306.0,3
110000,6,1968,1392,1392,2784,278.4,2
137500,4,1972,1138,1181,2319,196.83333333333334,2
423000,8,2005,2077,2097,4174,262.125,3
230500,8,2000,1406,1936,3342,276.57142857142856,2
129000,6,1965,1021,2380,3401,340.0,2
193500,6,1994,1408,1679,3087,239.85714285714286,2
168000,5,1956,1188,1437,2625,239.5,2
137500,4,1922,700,1180,1880,236.0,1
173500,6,2005,738,1476,2214,210.85714285714286,2
103600,6,1925,672,1369,2041,228.16666666666666,1
165000,6,1977,1208,1208,2416,201.33333333333334,2
257500,6,1957,1477,1839,3316,262.7142857142857,2
140000,6,1965,1136,1136,2272,227.2,1
148500,6,1978,855,1441,2296,205.85714285714286,2
87000,4,1900,1095,1774,2869,221.75,3
109500,5,1924,768,792,1560,158.4,1
372500,8,2008,2046,2046,4092,292.2857142857143,3
128500,5,1961,988,988,1976,197.6,2
143000,6,1980,923,923,1846,184.6,1
159434,5,1932,793,1520,2313,253.33333333333334,1
173000,6,1996,1291,1291,2582,215.16666666666666,2
285000,9,2002,1626,1668,3294,238.28571428571428,3
221000,7,1998,1195,1839,3034,262.7142857142857,2
207500,7,1984,1190,2090,3280,348.3333333333333,2
227875,7,2007,874,1761,2635,251.57142857142858,2
148800,7,2004,551,1102,1653,275.5,2
392000,8,2007,1419,1419,2838,202.71428571428572,2
194700,6,2005,1362,1362,2724,227.0,2
141000,6,2004,848,848,1696,282.6666666666667,2
755000,10,1994,2444,4316,6760,431.6,3
335000,7,1989,1210,2519,3729,279.8888888888889,2
108480,5,1921,1073,1073,2146,268.25,1
141500,5,1936,927,1539,2466,307.8,2
176000,6,1987,1112,1137,2249,227.4,2
89000,5,1921,616,616,1232,154.0,1
123500,5,1952,980,1148,2128,191.33333333333334,1
138500,5,1965,894,894,1788,178.8,1
196000,7,2004,1391,1391,2782,278.2,2
312500,8,2002,1800,1800,3600,257.14285714285717,3
140000,7,1969,1164,1164,2328,194.0,2
361919,8,2006,1234,2576,3810,257.6,3
140000,5,1900,360,1812,2172,226.5,2
213000,7,2004,1473,1484,2957,212.0,2
55000,4,1930,0,1092,1092,156.0,0
302000,7,1971,1643,1824,3467,364.8,2
254000,8,2006,1324,1324,2648,220.66666666666666,2
179540,7,2007,728,1456,2184,182.0,2
109900,5,1966,876,904,1780,150.66666666666666,1
52000,3,1935,270,729,999,145.8,0
102776,4,1900,859,1178,2037,168.28571428571428,1
189000,8,1988,1228,1228,2456,245.6,2
129000,4,1970,960,960,1920,160.0,2
130500,6,1976,725,1479,2204,246.5,2
165000,6,1974,1064,1350,2414,192.85714285714286,2
159500,7,1890,718,2554,3272,319.25,2
157000,5,1973,1176,1178,2354,235.6,2
341000,7,1993,1311,2418,3729,268.6666666666667,3
128500,5,1969,971,971,1942,194.2,1
275000,8,1985,1742,1742,3484,348.4,2
143000,6,2004,848,848,1696,282.6666666666667,2
124500,4,1970,864,864,1728,172.8,2
135000,4,1954,941,1470,2411,210.0,1
320000,9,2007,1698,1698,3396,212.25,3
120500,4,1970,864,864,1728,172.8,2
222000,6,1988,880,1680,2560,336.0,2
194500,7,2007,1232,1232,2464,205.33333333333334,2
110000,5,1958,1584,1776,3360,197.33333333333334,3
103000,4,1925,780,1208,1988,241.6,2
236500,8,1995,1595,1616,3211,323.2,2
187500,7,2003,868,1146,2014,191.0,2
222500,7,1998,1153,2031,3184,253.875,2
131400,5,1961,864,1144,2008,190.66666666666666,1
108000,5,1968,948,948,1896,158.0,1
163000,7,1914,880,1768,2648,294.6666666666667,2
93500,3,1950,0,1040,1040,173.33333333333334,2
239900,8,2005,893,1801,2694,225.125,3
179000,5,1987,1200,1200,2400,240.0,0
190000,7,2004,864,1728,2592,246.85714285714286,2
132000,5,1910,264,1432,1696,204.57142857142858,2
142000,6,1961,912,912,1824,182.4,1
179000,7,2000,1349,1349,2698,224.83333333333334,2
175000,5,1963,520,1464,1984,244.0,2
180000,8,1993,1337,1337,2674,267.4,2
299800,8,1976,1142,2715,3857,246.8181818181818,2
236000,7,2000,952,2256,3208,282.0,2
265979,7,1880,1240,2640,3880,330.0,4
260400,7,1996,1720,1720,3440,245.71428571428572,2
98000,4,1945,0,1529,1529,169.88888888888889,1
96500,4,1910,576,1140,1716,162.85714285714286,0
162000,7,2003,660,1320,1980,220.0,2
217000,6,1997,1479,1494,2973,249.0,2
275500,8,2005,1030,2098,3128,262.25,3
156000,6,1969,1026,1026,2052,205.2,2
172500,6,1999,729,1471,2200,245.16666666666666,2
212000,8,2007,866,1768,2634,252.57142857142858,2
158900,6,1978,672,1386,2058,231.0,2
179400,7,1999,744,1501,2245,250.16666666666666,2
290000,8,1995,1318,2531,3849,281.22222222222223,3
127500,6,1959,864,864,1728,172.8,1
100000,5,1924,1145,1301,2446,260.2,2
215200,7,2009,756,1547,2303,221.0,2
337000,8,1999,1252,2365,3617,295.625,3
270000,8,1995,1494,1494,2988,249.0,2
264132,9,2008,1498,1506,3004,251.0,2
196500,7,1988,980,1714,2694,244.85714285714286,2
160000,6,1940,983,1750,2733,250.0,1
216837,7,2004,1860,1836,3696,229.5,2
538000,8,2003,1650,3279,4929,273.25,3
134900,5,1982,858,858,1716,171.6,2
102000,4,1951,836,1220,2056,203.33333333333334,2
107000,6,1976,1029,1117,2146,186.16666666666666,2
114500,5,1958,912,912,1824,182.4,1
395000,8,2006,1935,1973,3908,219.22222222222223,3
162000,6,1998,1204,1204,2408,240.8,2
221500,7,2005,1614,1614,3228,230.57142857142858,3
142500,5,1974,864,894,1758,178.8,2
144000,5,1977,0,2020,2020,202.0,2
135000,6,1977,975,1004,1979,251.0,2
176000,7,1995,1237,1253,2490,208.83333333333334,2
175900,6,1992,761,1603,2364,229.0,2
187100,7,2001,1413,1430,2843,238.33333333333334,2
165500,5,1978,1097,1110,2207,277.5,2
128000,6,1914,742,1484,2226,164.88888888888889,0
161500,6,1967,1372,1342,2714,191.71428571428572,2
139000,5,1915,686,1652,2338,236.0,1
233000,7,2004,956,2084,3040,260.5,2
107900,4,1954,901,901,1802,225.25,1
187500,6,1966,832,2087,2919,231.88888888888889,2
160200,7,2005,1145,1145,2290,229.0,2
146800,6,1976,1029,1062,2091,212.4,2
269790,7,1996,1117,2013,3130,251.625,2
225000,8,2007,1496,1496,2992,213.71428571428572,2
194500,7,1994,712,1895,2607,270.7142857142857,2
171000,6,1980,650,1564,2214,223.42857142857142,2
143500,6,1977,660,1285,1945,183.57142857142858,2
110000,5,1953,773,773,1546,193.25,1
485000,9,2008,1926,3140,5066,285.45454545454544,3
175000,5,1937,731,1768,2499,252.57142857142858,1
200000,6,1997,616,1688,2304,211.0,2
109900,4,1916,1196,1196,2392,239.2,2
189000,7,2005,728,1456,2184,208.0,2
582933,9,2008,1734,2822,4556,235.16666666666666,3
118000,5,1954,936,1128,2064,225.6,1
227680,7,2008,1417,1428,2845,238.0,2
135500,5,1967,980,980,1960,163.33333333333334,1
223500,5,1923,1324,1576,2900,262.6666666666667,2
159950,5,1966,1024,1086,2110,181.0,2
106000,5,1898,849,2138,2987,194.36363636363637,2
181000,6,1974,1040,1309,2349,261.8,2
144500,6,2004,848,848,1696,212.0,2
55993,5,1952,540,1044,1584,261.0,2
157900,6,1958,1442,1442,2884,206.0,1
116000,5,1918,686,1250,1936,178.57142857142858,1
224900,7,1998,1649,1661,3310,276.8333333333333,2
137000,5,1954,1008,1008,2016,252.0,1
271000,8,2002,1568,1689,3257,241.28571428571428,3
155000,6,1971,1010,1052,2062,175.33333333333334,2
224000,7,2009,1358,1358,2716,226.33333333333334,2
183000,7,2003,798,1640,2438,273.3333333333333,2
93000,4,1953,936,936,1872,234.0,2
225000,7,2003,847,1733,2580,247.57142857142858,2
139500,6,1940,778,1489,2267,212.71428571428572,1
232600,8,2006,1489,1489,2978,212.71428571428572,2
385000,10,2007,2078,2084,4162,297.7142857142857,3
109500,5,1924,784,784,1568,156.8,0
189000,7,2001,1454,1434,2888,239.0,2
185000,5,1967,1013,2126,3139,303.7142857142857,2
147400,7,2005,600,1223,1823,305.75,2
166000,6,1957,1392,1392,2784,232.0,2
151000,7,2005,600,1200,1800,300.0,2
237000,7,2003,941,1829,2770,261.2857142857143,2
167000,6,1964,1516,1516,3032,252.66666666666666,2
139950,5,1961,1144,1144,2288,190.66666666666666,2
128000,4,1950,1067,1067,2134,266.75,2
153500,5,1948,1559,1559,3118,311.8,2
100000,6,1973,483,987,1470,197.4,1
144000,5,1995,1099,1099,2198,183.16666666666666,1
130500,5,1946,768,1200,1968,200.0,1
140000,6,1925,672,1482,2154,211.71428571428572,1
157500,5,1904,650,1539,2189,192.375,2
174900,6,1966,1127,1165,2292,194.16666666666666,2
141000,5,1961,1800,1800,3600,180.0,0
153900,5,1915,876,1416,2292,202.28571428571428,3
171000,5,1975,1390,1701,3091,283.5,2
213000,7,1993,740,1775,2515,253.57142857142858,2
133500,5,1972,864,864,1728,172.8,1
240000,6,1908,907,2358,3265,235.8,2
187000,6,1976,528,1855,2383,265.0,2
131500,6,2003,848,848,1696,282.6666666666667,2
215000,8,2003,1273,1456,2729,208.0,2
164000,7,1941,918,1646,2564,235.14285714285714,1
158000,6,1964,1127,1445,2572,206.42857142857142,2
170000,5,1955,1763,1779,3542,296.5,2
127000,5,1962,1040,1040,2080,173.33333333333334,1
147000,6,1978,940,1026,1966,205.2,2
174000,6,1994,702,1481,2183,246.83333333333334,2
152000,7,1976,1090,1370,2460,228.33333333333334,2
250000,6,1968,1054,2654,3708,294.8888888888889,2
189950,7,1918,912,1426,2338,203.71428571428572,1
131500,5,1965,1039,1039,2078,173.16666666666666,2
152000,6,1984,1040,1097,2137,182.83333333333334,2
132500,5,1959,1148,1148,2296,191.33333333333334,1
250580,7,2007,1372,1372,2744,228.66666666666666,2
148500,5,1970,1002,1002,2004,200.4,2
248900,8,2006,1638,1646,3284,274.3333333333333,3
129000,4,1961,1040,1120,2160,224.0,2
169000,5,1948,0,2320,2320,331.42857142857144,2
236000,7,1993,1050,1949,2999,243.625,2
109500,5,1962,894,894,1788,178.8,1
200500,6,1998,804,1682,2486,240.28571428571428,2
116000,5,1953,105,910,1015,182.0,2
133000,5,1949,832,1268,2100,211.33333333333334,1
66500,5,1941,676,1131,1807,226.2,1
303477,8,2007,1184,2610,3794,237.27272727272728,2
132250,4,1963,1064,1040,2104,208.0,2
350000,9,2004,1462,2224,3686,222.4,3
148000,5,1961,1109,1155,2264,192.5,2
136500,5,1978,864,864,1728,144.0,1
157000,5,2005,1090,1090,2180,218.0,2
187500,7,1990,1156,1717,2873,245.28571428571428,2
178000,6,1992,808,1593,2401,227.57142857142858,2
118500,4,1912,795,2230,3025,223.0,1
100000,5,1967,892,892,1784,178.4,1
328900,9,1999,1698,1709,3407,341.8,2
145000,5,1959,1626,1712,3338,214.0,2
135500,5,1955,816,1393,2209,174.125,1
268000,8,1970,2217,2217,4434,277.125,2
149500,6,1953,1505,1505,3010,250.83333333333334,2
122900,5,1949,672,924,1596,154.0,2
172500,6,1978,918,1683,2601,240.42857142857142,2
154500,6,1963,1059,1068,2127,178.0,1
165000,5,1954,1383,1383,2766,230.5,1
118858,5,1979,0,1535,1535,191.875,2
140000,6,1963,780,1796,2576,224.5,2
106500,4,1936,951,951,1902,158.5,1
142953,5,1979,0,2240,2240,186.66666666666666,2
611657,9,2009,2330,2364,4694,214.9090909090909,3
135000,5,1961,912,1236,2148,206.0,1
110000,4,1971,858,858,1716,214.5,1
153000,5,1957,992,1306,2298,261.2,1
180000,7,2003,783,1509,2292,188.625,2
240000,7,2006,1670,1670,3340,238.57142857142858,3
125500,5,1967,876,902,1778,150.33333333333334,1
128000,5,1954,1056,1063,2119,177.16666666666666,1
255000,8,2006,1623,1636,3259,204.5,3
250000,7,1936,1017,2057,3074,342.8333333333333,1
131000,5,1983,864,902,1766,180.4,2
174000,6,2005,742,1484,2226,185.5,2
154300,5,1960,1105,2274,3379,189.5,2
143500,5,1977,1268,1268,2536,253.6,1
88000,5,1925,768,1015,1783,169.16666666666666,1
145000,5,1949,1001,2002,3003,250.25,3
173733,6,2009,612,1224,1836,306.0,2
75000,4,1970,546,1092,1638,182.0,1
35311,2,1949,480,480,960,120.0,1
135000,4,1956,1134,1229,2363,204.83333333333334,1
238000,7,1991,1104,2127,3231,265.875,3
176500,6,1958,1184,1414,2598,235.66666666666666,2
201000,6,1994,928,1721,2649,245.85714285714286,2
145900,5,1900,1272,2200,3472,244.44444444444446,0
169990,6,2005,1316,1316,2632,219.33333333333334,2
193000,6,1993,1604,1617,3221,323.4,2
207500,6,1980,1686,1686,3372,240.85714285714286,2
175000,5,1977,1126,1126,2252,187.66666666666666,2
285000,8,2003,1181,2374,3555,237.4,3
176000,7,1968,832,1978,2810,219.77777777777777,2
236500,8,2001,1753,1788,3541,255.42857142857142,2
222000,7,1997,964,2236,3200,279.5,2
201000,8,2007,1466,1466,2932,209.42857142857142,3
117500,5,1965,925,925,1850,185.0,1
320000,9,2006,1905,1905,3810,238.125,3
190000,7,2004,1500,1500,3000,250.0,2
242000,7,1960,585,2069,2654,229.88888888888889,2
79900,4,1926,600,747,1347,149.4,2
184900,7,2003,1176,1200,2376,240.0,2
253000,7,2005,1113,1971,3084,246.375,2
239799,7,2006,1391,1962,3353,280.2857142857143,3
244400,7,1940,1032,2403,3435,240.3,1
150900,6,1976,1728,1728,3456,216.0,2
214000,7,1999,992,2060,3052,257.5,2
150000,4,1977,1440,1440,2880,180.0,0
143000,5,1967,1632,1632,3264,204.0,2
137500,6,1958,819,1344,2163,192.0,2
124900,5,1890,1088,1869,2957,267.0,2
143000,5,1959,1144,1144,2288,190.66666666666666,1
270000,8,2002,1616,1629,3245,181.0,3
192500,7,2002,936,1776,2712,253.71428571428572,2
197500,6,1972,1161,1381,2542,276.2,2
129000,5,1950,864,864,1728,172.8,2
119900,5,1965,828,965,1793,160.83333333333334,1
133900,5,1972,768,768,1536,153.6,1
172000,5,1969,784,1968,2752,281.14285714285717,2
127500,6,1975,945,980,1925,245.0,0
145000,6,1946,979,1958,2937,244.75,2
124000,6,1980,561,1229,1790,245.8,2
132000,5,1962,1057,1057,2114,176.16666666666666,2
185000,7,2003,1337,1337,2674,222.83333333333334,2
155000,7,1999,696,1416,2112,236.0,2
116500,5,1958,858,858,1716,214.5,0
272000,6,1977,1330,2872,4202,261.09090909090907,2
155000,6,1976,804,1548,2352,221.14285714285714,2
239000,9,2007,1800,1800,3600,257.14285714285717,2
214900,7,2002,817,1894,2711,236.75,2
178900,6,2005,783,1484,2267,185.5,2
160000,5,1940,728,1308,2036,186.85714285714286,1
135000,5,1955,1098,1098,2196,183.0,1
37900,3,1910,600,968,1568,161.33333333333334,0
140000,6,1958,588,1095,1683,182.5,1
135000,4,1949,720,1192,1912,198.66666666666666,0
173000,7,2003,764,1626,2390,271.0,2
99500,6,1979,918,918,1836,183.6,1
182000,7,2007,1428,1428,2856,238.0,2
167500,7,1910,728,2019,2747,252.375,2
165000,7,2000,673,1382,2055,230.33333333333334,2
85500,4,1923,440,869,1309,217.25,0
199900,7,2006,1241,1241,2482,310.25,2
110000,4,1954,894,894,1788,178.8,2
139000,5,1963,1121,1121,2242,224.2,2
178400,7,1961,944,999,1943,166.5,2
336000,8,1998,1225,2612,3837,326.5,3
159895,7,2007,1266,1266,2532,211.0,2
255900,8,2002,1128,2290,3418,254.44444444444446,2
126000,5,1977,0,1734,1734,216.75,2
125000,5,1950,1164,1164,2328,232.8,1
117000,6,1910,485,1635,2120,327.0,1
395192,9,2009,1930,1940,3870,242.5,3
195000,6,1976,848,2030,2878,253.75,2
197000,7,2006,770,1576,2346,262.6666666666667,2
348000,8,1997,1396,2392,3788,341.7142857142857,3
168000,8,1882,916,1742,2658,217.75,2
187000,6,1964,822,1851,2673,264.42857142857144,2
173900,6,2005,750,1500,2250,250.0,2
337500,10,2006,1700,1718,3418,245.42857142857142,3
121600,4,1946,747,1230,1977,246.0,1
136500,5,1961,1050,1050,2100,175.0,1
185000,6,1970,1442,1442,2884,240.33333333333334,2
91000,3,1922,1007,1077,2084,179.5,1
206000,7,2006,1187,1208,2395,201.33333333333334,2
82000,3,1952,0,944,944,236.0,2
86000,5,1920,691,691,1382,172.75,1
232000,8,2006,1574,1574,3148,224.85714285714286,3
136905,5,1976,1680,1680,3360,210.0,2
181000,7,2005,1346,1504,2850,214.85714285714286,2
149900,5,1977,985,985,1970,164.16666666666666,1
163500,6,1970,1657,1657,3314,236.71428571428572,2
88000,4,1970,546,1092,1638,182.0,1
240000,7,2004,1710,1710,3420,244.28571428571428,2
102000,5,1926,1008,1522,2530,217.42857142857142,0
135000,5,1948,720,1271,1991,181.57142857142858,1
100000,5,1965,0,1664,1664,208.0,0
165000,6,1923,602,1502,2104,214.57142857142858,1
85000,5,1910,1022,1022,2044,255.5,1
119200,6,1948,1082,1082,2164,216.4,1
227000,8,2001,810,1665,2475,277.5,2
203000,7,1996,1504,1504,3008,250.66666666666666,2
187500,8,1984,1220,1360,2580,340.0,2
160000,7,1991,384,1472,1856,210.28571428571428,2
213490,7,2005,1362,1506,2868,251.0,2
176000,4,2005,1132,1132,2264,226.4,2
194000,7,2006,1199,1220,2419,203.33333333333334,2
87000,5,1930,912,1248,2160,208.0,1
191000,7,2005,1346,1504,2850,214.85714285714286,2
287000,8,1976,1565,2898,4463,289.8,2
112500,5,1972,882,882,1764,176.4,2
167500,5,1960,1268,1264,2532,210.66666666666666,2
293077,8,2007,1638,1646,3284,235.14285714285714,3
105000,5,1941,768,1376,2144,229.33333333333334,1
118000,6,1972,672,1218,1890,174.0,1
160000,5,1916,686,1928,2614,192.8,0
197000,7,1920,824,3082,3906,256.8333333333333,2
310000,8,1993,1338,2520,3858,252.0,3
230000,7,2002,1654,1654,3308,275.6666666666667,3
119750,5,1938,920,954,1874,190.8,1
84000,4,1957,0,845,845,169.0,1
315500,9,2007,1620,1620,3240,270.0,3
287000,8,2001,1055,2263,3318,323.2857142857143,2
97000,4,1970,546,1344,1890,224.0,0
80000,4,1970,630,630,1260,210.0,1
155000,5,1957,1134,1803,2937,225.375,2
173000,6,1966,800,1632,2432,233.14285714285714,2
196000,6,2005,1306,1306,2612,261.2,2
262280,7,1990,1475,2329,3804,232.9,2
278000,8,1981,2524,2524,5048,280.44444444444446,2
139600,3,1955,0,1733,1733,216.625,2
556581,9,2005,1992,2868,4860,260.72727272727275,3
145000,5,1994,990,990,1980,198.0,2
115000,5,1960,0,1771,1771,196.77777777777777,2
84900,4,1946,0,930,930,155.0,1
176485,7,2007,1302,1302,2604,217.0,2
200141,7,2007,1316,1316,2632,219.33333333333334,2
165000,6,1964,816,1977,2793,219.66666666666666,2
144500,5,1957,1216,1526,2742,218.0,1
255000,8,2002,1065,1989,3054,284.14285714285717,2
180000,6,1976,1193,1523,2716,217.57142857142858,2
185850,7,2005,1364,1364,2728,227.33333333333334,2
248000,7,1994,973,1850,2823,264.2857142857143,2
335000,9,2008,1104,2184,3288,218.4,3
220000,6,1932,854,1991,2845,284.42857142857144,2
213500,8,2001,1338,1338,2676,223.0,2
81000,3,1935,894,894,1788,149.0,3
90000,5,1900,662,2337,2999,233.7,2
110500,6,1925,1103,1103,2206,220.6,2
154000,5,1966,1154,1154,2308,192.33333333333334,2
328000,7,1996,1306,2260,3566,322.85714285714283,2
178000,6,1993,799,1571,2370,224.42857142857142,2
167900,6,1964,780,1611,2391,230.14285714285714,2
151400,6,1973,942,2521,3463,252.1,2
135000,5,1949,845,893,1738,223.25,2
135000,5,1956,1048,1048,2096,174.66666666666666,1
154000,6,1968,727,1556,2283,194.5,2
91500,5,1948,810,1456,2266,208.0,1
159500,6,1977,690,1426,2116,237.66666666666666,2
194000,7,2006,1240,1240,2480,248.0,3
219500,7,1940,800,1740,2540,290.0,1
170000,5,1936,796,1466,2262,209.42857142857142,2
138800,5,1969,1096,1096,2192,182.66666666666666,1
155900,6,2004,848,848,1696,282.6666666666667,2
126000,5,1994,990,990,1980,198.0,1
145000,6,1971,1258,1258,2516,251.6,2
133000,5,1963,1040,1040,2080,208.0,1
192000,7,2002,1459,1459,2918,243.16666666666666,2
160000,6,1964,1251,1251,2502,208.5,1
187500,6,1995,691,1498,2189,249.66666666666666,2
147000,6,1992,936,996,1932,199.2,2
83500,4,1973,546,1092,1638,182.0,1
252000,8,2005,1082,1953,3035,217.0,3
137500,7,2004,970,1709,2679,244.14285714285714,2
197000,8,2005,1247,1247,2494,311.75,2
92900,3,1950,0,1040,1040,173.33333333333334,2
160000,7,1999,600,1252,1852,313.0,2
136500,6,1925,1181,1694,2875,242.0,2
146000,5,1965,864,1200,2064,200.0,2
129000,5,1956,936,936,1872,234.0,1
176432,6,2006,1314,1314,2628,219.0,2
127000,6,1914,684,1355,2039,193.57142857142858,0
170000,8,1986,1074,1088,2162,217.6,2
128000,4,1936,672,1324,1996,220.66666666666666,1
157000,7,1978,1271,1601,2872,228.71428571428572,2
60000,2,1920,290,438,728,146.0,1
119500,5,1971,950,950,1900,190.0,1
135000,5,1960,1010,1134,2144,189.0,1
159500,6,1959,655,1194,1849,199.0,2
106000,5,1970,630,1302,1932,217.0,2
325000,8,1994,1463,2622,4085,291.3333333333333,2
179900,7,1990,910,1442,2352,240.33333333333334,2
274725,7,2006,868,2021,2889,224.55555555555554,2
181000,6,2000,924,1690,2614,241.42857142857142,2
280000,8,2004,1836,1836,3672,262.2857142857143,3
188000,6,1995,773,1658,2431,207.25,2
205000,7,1976,803,1964,2767,245.5,2
129900,5,1957,816,816,1632,163.2,1
134500,5,1953,1008,1008,2016,168.0,1
117000,5,1954,833,833,1666,208.25,1
318000,8,2007,1734,1734,3468,247.71428571428572,3
184100,8,2002,408,1419,1827,202.71428571428572,2
130000,5,1967,894,894,1788,178.8,2
140000,5,1958,533,1601,2134,266.8333333333333,1
133700,5,1959,1040,1040,2080,173.33333333333334,1
118400,6,1920,1012,1012,2024,168.66666666666666,1
212900,7,2005,1552,1552,3104,221.71428571428572,3
112000,4,1956,672,960,1632,192.0,1
118000,5,1947,698,698,1396,174.5,0
163900,7,1992,384,1482,1866,211.71428571428572,2
115000,4,1955,1005,1005,2010,201.0,2
174000,7,2007,1373,1555,2928,222.14285714285714,3
259000,7,2004,1530,1530,3060,218.57142857142858,3
215000,7,2004,847,1959,2806,244.875,2
140000,5,1980,936,936,1872,234.0,2
135000,4,1928,1122,1981,3103,283.0,2
93500,5,1991,974,974,1948,194.8,0
117500,6,1880,1008,2210,3218,276.25,1
239500,8,1995,1128,2020,3148,252.5,2
169000,6,1997,916,1600,2516,228.57142857142858,2
102000,6,1926,960,986,1946,197.2,1
119000,6,1950,1032,1252,2284,208.66666666666666,1
94000,5,1875,780,1020,1800,170.0,0
196000,6,1977,1567,1567,3134,313.4,2
144000,5,1920,915,1167,2082,194.5,2
139000,5,1951,952,952,1904,238.0,2
197500,5,1976,780,1868,2648,207.55555555555554,2
424870,8,2006,1466,2828,4294,257.09090909090907,3
80000,5,1959,1006,1006,2012,201.2,0
80000,4,1941,672,924,1596,184.8,1
149000,5,1928,1042,1576,2618,197.0,1
180000,6,1985,1298,1298,2596,259.6,2
174500,7,1941,704,1564,2268,223.42857142857142,1
116900,7,1926,572,1111,1683,222.2,1
143000,7,1920,650,1482,2132,211.71428571428572,2
124000,6,1950,932,932,1864,233.0,1
149900,5,1959,1466,1466,2932,244.33333333333334,2
230000,6,1956,1073,1811,2884,301.8333333333333,2
120500,6,1930,816,816,1632,163.2,1
201800,7,1965,864,1820,2684,227.5,2
218000,5,1976,1437,1437,2874,239.5,2
179900,5,1965,1219,1265,2484,210.83333333333334,2
230000,7,2007,1314,1314,2628,219.0,2
235128,8,2007,1580,1580,3160,225.71428571428572,3
185000,6,1974,901,1876,2777,234.5,2
146000,6,1978,855,1456,2311,208.0,2
224000,6,1954,1296,1640,2936,234.28571428571428,2
129000,5,1968,894,894,1788,178.8,2
108959,4,1969,1198,1258,2456,209.66666666666666,2
194000,5,1978,1360,1432,2792,286.4,2
233170,7,2009,1502,1502,3004,214.57142857142858,2
245350,8,2008,1694,1694,3388,242.0,3
173000,6,2000,959,1671,2630,238.71428571428572,2
235000,6,1935,1127,2108,3235,301.14285714285717,2
625000,10,1995,1930,3627,5557,362.7,3
171000,6,1977,1096,1118,2214,186.33333333333334,1
163000,6,1958,1261,1261,2522,210.16666666666666,2
171900,7,2006,625,1250,1875,250.0,2
200500,5,1946,1598,3086,4684,257.1666666666667,0
239000,6,1932,952,2345,3297,260.55555555555554,2
285000,8,1992,1683,2872,4555,319.1111111111111,2
119500,5,1984,876,923,1799,184.6,1
115000,6,1926,818,1224,2042,244.8,1
154900,5,1921,731,1343,2074,191.85714285714286,1
93000,5,1954,0,1124,1124,224.8,0
250000,7,1990,1216,2514,3730,314.25,2
392500,8,2008,1600,1652,3252,330.4,2
745000,10,1996,2396,4476,6872,447.6,3
120000,5,1920,1120,1130,2250,226.0,2
186700,5,1963,1572,1572,3144,314.4,3
104900,5,1924,784,1221,2005,174.42857142857142,1
95000,3,1900,978,1699,2677,242.71428571428572,2
262000,8,1994,1624,1624,3248,324.8,3
195000,7,2002,831,1660,2491,237.14285714285714,2
189000,7,1999,994,1804,2798,257.7142857142857,2
168000,4,1961,1249,1622,2871,231.71428571428572,4
174000,8,1999,776,1441,2217,288.2,2
125000,5,1925,702,1472,2174,245.33333333333334,1
165000,6,1999,1224,1224,2448,244.8,2
158000,6,1969,663,1352,2015,193.14285714285714,1
176000,6,2005,728,1456,2184,182.0,2
219210,7,2006,879,1863,2742,207.0,3
144000,7,1916,815,1690,2505,241.42857142857142,1
178000,7,2001,1212,1212,2424,202.0,2
148000,4,1963,1051,1382,2433,230.33333333333334,2
116050,4,1970,864,864,1728,172.8,1
197900,7,1998,866,1779,2645,296.5,2
117000,5,1925,884,1348,2232,269.6,1
213000,7,2000,1630,1630,3260,271.6666666666667,2
153500,5,1975,1056,1074,2130,179.0,2
271900,7,1990,2158,2196,4354,313.7142857142857,3
107000,4,1966,1056,1056,2112,211.2,1
200000,6,2003,1682,1700,3382,242.85714285714286,2
140000,5,1962,931,1283,2214,213.83333333333334,2
290000,8,2006,1660,1660,3320,207.5,2
189000,6,1992,1055,1845,2900,230.625,2
164000,8,1988,559,1752,2311,219.0,2
113000,4,1941,672,672,1344,168.0,1
145000,4,1965,648,960,1608,320.0,1
134500,5,1962,925,999,1924,166.5,1
125000,5,1966,894,894,1788,178.8,1
112000,6,1978,0,1902,1902,237.75,2
229456,8,2009,1300,1314,2614,219.0,2
80500,4,1947,0,912,912,304.0,0
91500,6,1971,672,1218,1890,174.0,0
115000,5,1964,912,912,1824,182.4,1
134000,5,1968,952,1211,2163,242.2,1
143000,6,1949,1040,1846,2886,263.7142857142857,1
137900,5,1951,2136,2136,4272,305.14285714285717,2
184000,7,2004,788,1490,2278,186.25,2
145000,6,1958,588,1138,1726,189.66666666666666,1
214000,6,2007,894,1933,2827,214.77777777777777,3
147000,5,1965,912,912,1824,182.4,2
367294,9,2008,1702,1702,3404,243.14285714285714,3
127000,5,1960,1075,1507,2582,215.28571428571428,1
190000,5,1977,1361,2620,3981,218.33333333333334,2
132500,5,1962,1106,1190,2296,198.33333333333334,2
101800,4,1962,0,1224,1224,204.0,2
142000,5,1959,1188,1188,2376,198.0,2
130000,5,1911,940,1964,2904,280.57142857142856,0
138887,5,1914,747,1784,2531,198.22222222222223,1
175500,7,2003,764,1626,2390,271.0,2
195000,7,2004,847,1948,2795,243.5,2
142500,6,2005,1141,1141,2282,190.16666666666666,2
265900,8,2006,1476,1484,2960,247.33333333333334,2
224900,7,2003,884,1768,2652,221.0,2
248328,7,2007,1689,1689,3378,241.28571428571428,3
170000,7,1974,1053,1173,2226,195.5,2
465000,10,2006,2076,2076,4152,296.57142857142856,3
230000,8,1929,792,1517,2309,216.71428571428572,2
178000,6,1984,585,1868,2453,266.85714285714283,2
186500,7,2005,756,1553,2309,258.8333333333333,2
169900,6,1976,1012,1034,2046,172.33333333333334,3
129500,6,1917,735,2058,2793,257.25,2
119000,5,1950,876,988,1864,164.66666666666666,1
244000,7,1968,2110,2110,4220,263.75,2
171750,7,2003,1405,1405,2810,234.16666666666666,2
130000,5,1968,864,874,1738,174.8,1
294000,7,1974,1192,2167,3359,240.77777777777777,2
165400,7,2003,746,1656,2402,236.57142857142858,2
127500,6,1931,884,1367,2251,227.83333333333334,1
301500,8,1994,1986,1987,3973,283.85714285714283,2
99900,5,1922,864,864,1728,216.0,0
190000,7,2005,856,1166,2022,233.2,2
151000,6,1969,1054,1054,2108,175.66666666666666,2
181000,6,1999,841,1675,2516,239.28571428571428,2
128900,5,1956,1050,1050,2100,210.0,1
161500,4,1957,1104,1788,2892,223.5,1
180500,6,1919,764,1824,2588,228.0,2
181000,6,1998,1405,1337,2742,267.4,2
183900,7,1999,691,1452,2143,242.0,2
122000,7,1910,925,1889,2814,209.88888888888889,1
378500,9,2008,2002,2018,4020,201.8,3
381000,8,1935,728,3447,4175,313.3636363636364,3
144000,5,1958,874,1524,2398,217.71428571428572,1
260000,7,1979,1332,1524,2856,381.0,2
185750,6,1968,1489,1489,2978,212.71428571428572,2
137000,5,1965,935,935,1870,187.0,1
177000,6,1959,1019,1357,2376,271.4,1
139000,5,1910,661,1250,1911,156.25,2
137000,5,1948,928,1920,2848,192.0,2
162000,6,1972,723,1395,2118,232.5,2
197900,6,1967,1680,1724,3404,246.28571428571428,2
237000,8,2002,1128,2031,3159,290.14285714285717,2
68400,4,1920,698,1128,1826,188.0,2
227000,7,2002,1573,1573,3146,262.1666666666667,2
180000,7,1990,1309,1339,2648,223.16666666666666,2
150500,5,1977,1040,1040,2080,208.0,2
139000,6,1971,912,1824,2736,228.0,0
169000,6,1919,804,2447,3251,244.7,1
132500,6,1939,780,1412,2192,235.33333333333334,1
143000,6,1963,1328,1328,2656,221.33333333333334,2
190000,5,1964,1624,1582,3206,226.0,2
278000,8,2000,1501,1659,3160,331.8,2
281000,8,2006,1085,1970,3055,246.25,3
180500,5,1964,1152,1152,2304,192.0,2
119500,5,1972,630,1302,1932,217.0,1
107500,5,1892,994,2372,3366,215.63636363636363,1
162900,7,1976,832,1664,2496,208.0,2
115000,5,1955,864,864,1728,172.8,2
138500,5,1968,1052,1052,2104,210.4,1
155000,5,1963,1120,1128,2248,188.0,2
140000,6,2005,547,1072,1619,214.4,2
160000,10,2008,6110,5642,11752,470.1666666666667,2
154000,5,1959,1246,1246,2492,207.66666666666666,1
225000,7,1999,978,1983,2961,220.33333333333334,2
177500,6,1942,771,1494,2265,213.42857142857142,1
290000,8,1994,1165,2526,3691,315.75,3
232000,7,2005,1616,1616,3232,230.85714285714286,3
130000,7,2004,976,1708,2684,244.0,2
325000,9,2006,1652,1652,3304,275.3333333333333,2
202500,7,2005,1368,1368,2736,228.0,2
138000,5,1994,990,990,1980,198.0,2
147000,5,1948,924,1122,2046,187.0,2
179200,6,1991,1278,1294,2572,215.66666666666666,2
335000,7,1959,1902,1902,3804,271.7142857142857,2
203000,7,2005,1274,1274,2548,212.33333333333334,2
302000,8,1990,1453,2810,4263,312.22222222222223,2
333168,9,1999,1393,2599,3992,259.9,3
119000,4,1954,948,948,1896,189.6,1
206900,6,1969,952,2112,3064,234.66666666666666,2
295493,8,2008,1622,1630,3252,203.75,3
208900,7,2006,1352,1352,2704,270.4,2
275000,8,2001,1753,1787,3540,255.28571428571428,3
111000,4,1954,864,948,1812,189.6,1
156500,6,1957,1478,1478,2956,246.33333333333334,2
72500,3,1949,0,720,720,180.0,1
190000,7,1992,750,1923,2673,240.375,2
82500,4,1940,420,708,1128,141.6,0
147000,8,2006,1795,1795,3590,256.42857142857144,3
55000,4,1922,796,796,1592,159.2,0
79000,3,1931,544,774,1318,129.0,0
130500,5,1982,816,816,1632,163.2,1
256000,6,1920,1510,2792,4302,349.0,2
176500,7,1998,935,1632,2567,204.0,2
227000,8,2006,1588,1588,3176,226.85714285714286,3
132500,5,1976,911,954,1865,159.0,2
100000,4,1938,816,816,1632,272.0,1
125500,5,1938,803,1360,2163,226.66666666666666,1
125000,5,1970,765,1365,2130,195.0,2
167900,6,1977,1350,1334,2684,222.33333333333334,2
135000,5,1973,1656,1656,3312,207.0,2
52500,4,1941,693,693,1386,173.25,0
200000,7,2002,916,1861,2777,232.625,2
128500,5,1972,864,864,1728,172.8,1
123000,4,1971,858,872,1730,174.4,4
155000,6,2003,1114,1114,2228,185.66666666666666,2
228500,8,2002,1284,2169,3453,309.85714285714283,2
177000,6,1928,896,1913,2809,212.55555555555554,2
155835,7,2006,728,1456,2184,182.0,2
108500,4,1920,960,960,1920,192.0,1
262500,7,1968,1568,2156,3724,239.55555555555554,2
283463,8,2006,1732,1776,3508,253.71428571428572,3
215000,7,1998,1482,1494,2976,298.8,2
122000,8,1872,684,2358,3042,294.75,0
200000,5,1969,1248,2634,3882,219.5,4
171000,6,1962,858,1716,2574,214.5,2
134900,6,1937,698,1176,1874,294.0,2
410000,8,1995,2033,3238,5271,359.77777777777777,3
235000,7,2000,992,1865,2857,266.42857142857144,3
170000,7,1968,570,1920,2490,240.0,2
110000,5,1966,864,892,1756,178.4,1
149900,5,1971,1078,1078,2156,179.66666666666666,2
177500,6,2000,756,1573,2329,314.6,2
315000,9,2004,1980,1980,3960,247.5,3
189000,5,1921,612,2601,3213,325.125,2
260000,7,2005,1530,1530,3060,218.57142857142858,2
104900,4,1920,715,1738,2453,248.28571428571428,1
156932,6,2006,616,1412,2028,235.33333333333334,2
144152,7,2005,600,1200,1800,300.0,2
216000,7,2000,814,1674,2488,239.14285714285714,2
193000,7,1999,873,1790,2663,255.71428571428572,2
127000,5,1977,757,1475,2232,245.83333333333334,1
144000,6,2003,848,848,1696,212.0,2
232000,8,2003,1657,1668,3325,208.5,2
105000,4,1920,840,1374,2214,229.0,1
165500,6,1955,992,1661,2653,207.625,1
274300,7,1998,1108,2097,3205,262.125,2
466500,10,2001,2633,2633,5266,329.125,3
250000,7,2005,1026,1958,2984,217.55555555555554,3
239000,8,2007,1571,1571,3142,224.42857142857142,3
91000,6,1930,768,790,1558,197.5,1
117000,5,1941,984,1604,2588,267.3333333333333,2
83000,6,1973,483,987,1470,197.4,1
167500,5,2006,384,1394,1778,199.14285714285714,2
58500,3,1914,864,864,1728,172.8,1
237500,6,1970,1205,2117,3322,302.42857142857144,2
157000,7,1920,596,1762,2358,220.25,2
112000,5,1918,816,1416,2232,202.28571428571428,2
105000,6,1939,560,1258,1818,209.66666666666666,1
125500,4,1922,796,1154,1950,164.85714285714286,1
250000,7,1978,1392,2784,4176,232.0,2
136000,6,1916,714,2526,3240,252.6,1
377500,9,2006,1746,1746,3492,249.42857142857142,3
131000,6,1941,735,1218,1953,203.0,2
235000,7,2000,1525,1525,3050,254.16666666666666,2
124000,5,1967,1584,1584,3168,198.0,3
123000,5,1967,864,900,1764,150.0,1
163000,6,1905,482,1912,2394,273.14285714285717,2
246578,7,2006,1356,1500,2856,250.0,3
281213,8,2005,1094,2482,3576,275.77777777777777,3
160000,5,1948,747,1687,2434,241.0,2
137500,5,1920,939,1513,2452,189.125,1
138000,5,1950,1208,1904,3112,272.0,1
137450,6,1925,976,1608,2584,229.71428571428572,1
120000,6,1929,862,1158,2020,231.6,1
193000,6,2004,839,1593,2432,199.125,2
193879,7,2006,1286,1294,2580,215.66666666666666,2
282922,8,2007,1485,1464,2949,244.0,3
105000,3,1915,672,1214,1886,202.33333333333334,3
275000,8,2004,1594,1646,3240,329.2,2
133000,5,1972,768,768,1536,153.6,2
112000,5,1985,833,833,1666,166.6,0
125500,4,1910,622,1363,1985,227.16666666666666,2
215000,7,1986,791,2093,2884,299.0,2
230000,7,2001,944,1840,2784,306.6666666666667,2
140000,6,1950,856,1668,2524,278.0,1
90000,4,1949,0,1040,1040,173.33333333333334,2
257000,8,2005,1844,1844,3688,263.42857142857144,2
207000,6,1923,833,1848,2681,231.0,2
175900,7,2007,1386,1569,2955,224.14285714285714,3
122500,4,1885,777,2290,3067,208.1818181818182,2
340000,8,1998,1284,2450,3734,350.0,3
124000,5,1963,1144,1144,2288,190.66666666666666,1
223000,6,1969,1844,1844,3688,263.42857142857144,2
179900,6,1968,708,1416,2124,202.28571428571428,2
127500,6,1977,1069,1069,2138,267.25,2
136500,6,2003,848,848,1696,282.6666666666667,2
274970,6,1966,697,2201,2898,275.125,2
144000,5,1958,1024,1344,2368,224.0,1
142000,6,1959,1252,1252,2504,178.85714285714286,2
271000,7,1994,1223,2127,3350,425.4,2
140000,5,1945,913,1558,2471,259.6666666666667,1
119000,5,1940,788,804,1592,201.0,1
182900,6,1981,1440,1440,2880,205.71428571428572,2
192140,5,2005,732,1838,2570,262.57142857142856,2
143750,6,1976,958,958,1916,191.6,2
64500,4,1927,656,968,1624,193.6,1
186500,6,2000,936,1792,2728,224.0,2
160000,5,1977,1126,1126,2252,225.2,2
174000,6,1962,1319,1537,2856,219.57142857142858,2
120500,4,1971,864,864,1728,172.8,2
394617,8,2008,1932,1932,3864,276.0,3
149700,6,1957,912,1236,2148,206.0,2
197000,7,1979,539,1725,2264,287.5,2
191000,6,1922,588,2555,3143,232.27272727272728,2
149300,6,2004,848,848,1696,282.6666666666667,2
310000,10,2008,1017,2007,3024,200.7,3
121000,6,1916,952,952,1904,238.0,1
179600,7,2004,1422,1422,2844,203.14285714285714,2
129000,6,1966,814,913,1727,152.16666666666666,1
157900,5,1962,1188,1188,2376,198.0,1
240000,8,1995,1220,2090,3310,261.25,2
112000,4,1910,560,1346,1906,224.33333333333334,1
92000,5,1970,630,630,1260,210.0,0
136000,5,1974,896,1792,2688,224.0,0
287090,8,2008,1573,1578,3151,225.42857142857142,3
145000,5,2005,547,1072,1619,214.4,2
84500,5,2006,1140,1140,2280,190.0,0
185000,7,2004,1221,1221,2442,203.5,2
175000,6,1999,953,1647,2600,235.28571428571428,2
210000,6,1978,1542,2073,3615,296.14285714285717,2
266500,7,1941,1152,2340,3492,260.0,1
142125,5,1950,1078,1078,2156,215.6,1
147500,5,1965,1256,1256,2512,209.33333333333334,1
